知音当事人这个节目有多长时间？	45分钟	单位
影子卫士最后一集是什么时候更新的？	2014-04-25	日期
有没有人看过公主日记，对白是什么语言？	英语	语言
紫苏属拼音怎样拼？	zisushu	英文名
凤凰工业园总共面积有多大？	9.8平方公里	单位
麻烦请问一下潘氏指环虫一般在哪寄生？	鳃	字词
酒泉航天科技学院是啥类型的学校？	综合	词语
请问旗忠森林体育城网球中心是什么时候落成的？	2005年	日期
什么时候博恩霍意姆机场建成？	1935年	日期
谁是华东政法大学经济法学院的副院长？	陈岱松	人物
请问鱼-6型的弹径是多少？	533毫米	单位
节日营销的相关机构有什么？	发一把	公司
世界历史遗址基金会的总部在哪里？	纽约	外国行政区划
谁发明了薄料髹涂？ 	沈绍安	人物
提尔比兹号战列舰的长为多少？	253.6米	单位
安东尼·兰多夫的中文全名是什么？	小安东尼·欧文·兰多夫	人物
请问田泽湖流域哪个国家？	日本	国家
重庆工业博物馆是哪个单位提出的？	重庆市政府	组织机构
表皮毛是哪个学科的专业术语？ 	生物学	书籍
哪个公司设计了柳林南站？	太中银铁路	地点
沧海桑田针对于哪些人群？	儿童	词语
什么动物是李美凤最喜欢的？	小狗	人物
环球真经典系列之温拿是属于什么类别的专辑？ 	精选集	选集
洪都拉斯足球甲级联赛属于什么级别？	1	数字
你知道弗陵葬在哪里了吗？	平陵	地点
额节是哪个民族的？	水族	少数民族
什么时候哈依河五级水电站竣工？	2011年3月	日期
你知道龙仁站是什么时候废除的吗？	1972年4月1日	日期
你能详细解释一下精疲力竭症吗？	见下文	字词
万盛经济技术开发区隶属于哪个行政地区？	重庆市	直辖市
沙吐社区属于什么类别？	社区	地点
上海建桥学院有多少个重点学科？	1	数字
血肉缝合褶裙有哪些需要？	等级 78	词语
卢卡斯·波多尔斯基的俱乐部号码是多少？	11	数字
blkput的输入是什么？	mode - 象素写模式	行业人物
惠盐高速公路的设施有多少个？	8	数字
奇幻仙子是什么时候上架的？	2010-08-07 01:49	日期
心情七月使用的什么语言？	普通话	语言
斯宾塞·屈赛在哪个电影中获得最佳男主角？ 	最佳男主角 1937年 《怒海余生》 1938年 《孤儿乐园》	日期
新广州故事是哪一年的？	2013年	日期
你知道闪点行动第五季一集有多久吗？	42分钟	单位
大猫岛位于我国哪个省？	浙江省	行政区划
水仙子·重观瀑布的曲牌名是什么？	水仙子	动物
喀喇汗王朝是什么时候开始的？	840年	日期
你知道星系动物园主要语言是什么吗？	英语	语言
海盗之歌的分享类型是什么？	免费	词语
做铁板鱼要用到哪些调料？	粗盐 味精 鸡精	食品
《你猜你猜你猜猜猜》是哪个地区的？	台湾	书籍
旅游管理专业的主干学科是什么？ 	管理学 经济学	书籍
谁是希妲的恋人？	撼天阙	人物
宏富颐景园的配套设施状况如何？ 	完善	字词
狼蛛星云被称为什么？	“星空奇迹”	天体
张飞豆腐干是用来纪念谁的？	张飞	中国历史人物
大禹华邦应该什么时候交房？	2011-12-01	日期
谁是罪恶王冠的人物原案？	redjuice	英文名
深渊巨口有多少魔法攻击？	5	数字
金海岸天府花园水城在哪个城市或区县？	成都 / 金堂县	地点
小菘的头发是什么颜色？	黑色	词语
仮装舞踏会的译名是什么？	：化装舞会 / 化妆舞会 等	书籍
你知道双甸镇共有多少人吗？ 	7.97万	单位
左江水电站的水位在正常情况下是多少？	108m	单位
阆中玉台1887浙江会馆是什么时候筹建的？	1887年	日期
你知道杨檀古井的底径是多少吗？	3.2米	单位
封人属于哪个朝代？	春秋时期	阶段
highrock面向哪些市场？	全球	组织机构
马克思又叫什么？	摩尔	单位
松针油又叫做什么？	冷杉油	植物
寒兰亚属于什么？	建兰亚属	植物
卡尔文虫的分类地位是什么？	节肢动物门	植物
你了解重庆赛特标识设计制作中心的上市时间吗？	自2005年	日期
有人知道尚孕兰多是什么时候申请的吗？	2013-06-26	日期
大家知道泛华棋友是什么时候发行的吗？	1995	数字
长安国际新城共投资了多少钱？	260亿元	单位
红颜桃花可以用来形容什么样的人？	美女	书籍
至尊功德修仙系统的周点击率是多少？	3419	数字
嘉年华国际商务广场属于什么类型的物业？	写字楼	词语
你知道绿苞细齿南星（变种）来自哪里吗？	浙江天目山	景点
楠木渡的最低海拔是多少？	513米	单位
中传央美郑州校区与哪个单位合作？	河南新闻学院	学院
谁能说明一下滢的基本含义？	清澈	字词
多叶瓣轮叶的属名是什么？ 	瓣轮叶属	植物
自贡市中医院是医保定点吗？	是	字词
frns是什么时候出现的？	1970年	日期
联合国教育、科学及文化组织用中文如何简称？	联合国教科文组织	组织机构
谁可以解释一下飂叔安的含义？	飂 ，古国名。叔安 ，飂国国君名	字词
你知道边姓的属地在哪里吗？	陇西郡	地点
包头寿灵寺的周长是多少？	681米	单位
西沙中建岛的主权国家是什么？	中国	历史
耒耜经收录于哪里？	笠泽丛书	书籍
送狄尚书镇太原的作者是哪个朝代的？	唐代	朝代
七色★星露有音乐模式吗？	有	字词
你知道金格植是什么时候卸任的吗？	2013年5月	日期
大家知道小科学是哪个世纪的吗？	16世纪	古代史
西适宁的名称是什么？	西适宁	药品
请问混沌属于什么族群？	分裂一族	文学作品
铁生沟冶铁遗址是什么时候发掘的？	959年	日期
佩尔尼克足球俱乐部涉及了哪些项目？	足球	人物
你知道玩具后卫的格式是什么吗？ 	apk	英文名
陶昕然现在住在哪里？	北京市	首都
勾陈一的自转是多少？	~17 km/s	单位
